29 6 7 8 29 29 29 29 29 29 29 29 29 29 29 29 29 29 29 29 29 29 29 29 29
31 9 10 11 0 0 0 0 0 0 0 0 0 0 0 43 0 0 0 0 0 0 0 0 32
31 12 13 14 0 0 0 0 0 0 0 0 0 0 0 43 0 0 0 0 0 43 0 0 32
31 0 0 0 0 0 0 0 0 0 0 0 0 0 0 0 0 0 0 0 0 0 0 0 32
31 0 0 0 0 0 0 0 0 0 0 0 0 0 0 0 0 0 0 0 0 43 0 0 32
31 0 0 0 0 0 0 0 0 0 0 0 0 0 0 42 0 42 42 43 0 42 0 0 32
31 42 42 42 42 42 53 53 53 44 0 0 0 53 0 0 0 0 0 42 0 0 0 0 32
31 0 0 0 0 54 55 0 53 45 0 0 0 53 0 0 0 43 0 0 0 0 0 0 32
31 0 42 0 0 56 57 0 0 53 0 0 0 53 0 0 0 0 0 0 0 0 0 0 32
31 53 0 0 52 0 0 0 0 53 0 0 0 0 0 0 0 42 52 0 0 0 0 0 32
31 0 0 0 58 59 0 0 0 46 0 0 0 0 0 0 0 0 0 0 0 0 0 0 32
31 53 0 0 60 61 0 0 0 47 0 0 0 0 0 0 0 53 0 0 0 0 0 0 32
31 0 0 0 0 0 0 0 52 0 0 0 0 0 0 0 0 0 0 0 0 0 0 0 32
31 0 42 0 0 0 0 0 0 0 0 0 0 48 0 0 0 0 0 0 0 0 0 0 32
31 53 0 0 50 0 43 0 0 0 0 0 0 49 0 0 0 0 0 6 7 8 0 0 32
31 0 0 0 51 0 0 43 0 46 0 0 0 0 0 0 0 0 0 9 10 11 0 0 32
31 53 0 42 0 0 43 0 0 47 0 0 0 0 0 52 52 0 0 12 13 14 0 0 32
31 0 0 0 0 0 0 0 0 0 0 0 0 0 0 0 0 52 0 0 0 0 0 0 32
31 42 42 0 0 42 0 0 0 0 0 0 0 0 0 0 52 0 0 0 0 0 0 0 32
30 30 30 30 30 30 30 30 30 30 30 30 30 30 30 30 30 30 30 30 30 30 30 30 30
